11111111
10000001
10000001
1P0000X1
11111111
