WWWWWWWWWWWWWWWWWWWWWWWW
WAAAAAAAAAAAAAAAAAAAAAAW
WAAAAAAAAAAAAAAAAAAAAAAW
WAAPAAAAAAAAAAAAAAAAAAAW
WAAAAAAAAAAAAAAAAAAAAAAW
WAAAAAAAAAAAAAAAAAAAAAAW
WAAAAAAAAAAAAAAAAAAAAAAW
WAAAAAAAAAAAAAAAAAAAGAAW
WAAAAAAAAAAAAAAAAAAAAAAW
WWWWWWWWWWWWWWWWWWWWWWWW
