11111111
10000001
10000001
100000X1
11111111