AAAAAAAAAAAAAWAAAAAAAAAAA
AAWAAWWWWAAAAAAAAAAAWAAAA
AAAAAAAAAWWAAAWWAWWAAAAAA
AWWAAAAAAAAAAAAAAAAAAAAAA
AAAAAAWWWWAWAAAAAAWWWAAAA
PAAAAAAAAAAAAAAAAAAAAAAAA
AAAAAAAAAAAAAAAAAAAAAAAAA
BBBBBBBBBBBBBBBBBBBBBBBBB
BBBBBBBBBBBBBBBBBBBBBBBBB
BBSSSSSSSSSSSSSSSSSSSSSBB