BBBBBBBBBBBBBBBBBBBBBBBBB
BAAAAAAAAAAAAAAAAAAAAAAAB
BAAAAAAAAAAAAAAAAAAAAAAAB
BAAAAAAAAAAAAAAAAAAAAAAAB
BAAAAAAAAAAAAAATAAAAAAAAB
BAAPAAAAAAAAAAAAAAAAAAAAB
BAADDDDDDDDDDDDDDDDDDDAAB
BAAAAAAAAAAAAAAAAAAAAAAAB
BAAAAAAAAAAAAAAAAAAAAAAAB
BBBBBBBBBBBBBBBBBBBBBBBBB