WWWWWWWWWWWWWWWWWWWWWWWWW
WIIIIIIIIIIIIIIIIIIIIIIIW
WIIIIIIIIIIIIIIIIIIIIIIIW
WIIIIIIIIIIIIIIIIIIIIIIIW
WIIIIIAPAAAAAAAAGAIIIIIIW
WIIIIIIIIIIIIIIIIIIIIIIIW
WIIIIIIIIIIIIIIIIIIIIIIIW
WIIIIIIIIIIIIIIIIIIIIIIIW
WIIIIIIIIIIIIIIIIIIIIIIIW
WWWWWWWWWWWWWWWWWWWWWWWWW
