WWWWWWWWWWWWWWWWWWWWWWWWW
WIIIIIIIIIIIIIIIIIIIIIIIW
WIIIIIIIIIIIIIIIIIIIIIIIW
WIIIIIIIIIIIIIIIIIIIIIIIW
WIIIIIPAAAAAAAAAAAGIIIIIW
WIIIIIIIIIIIIIIIIIIIIIIIW
WIIIIIIIIIIIIIIIIIIIIIIIW
WIIIIIIIIIIIIIIIIIIIIIIIW
WIIIIIIIIIIIIIIIIIIIIIIIW
WWWWWWWWWWWWWWWWWWWWWWWWW
