AAAAAAAAAAAAAWWWWAAAAAAAA
AAAAWWWWAAAAAAAAAAAAWAAAA
AAAAAAAAAWWAAAWWAWWAAAAAA
AAWAAAAAAAAAAAAAAAAAAAAAA
AAAAAAWWWWAWAAAAAAWWWAAAA
PAAAAAAAAAAAAAAAAAAAAAAGA
AAAAAAAAAAAAAAAAAAAAAAAAA
BBBBBBBBBBBBBBBBBBBBBBBBB
BBBBBBBBBBBBBBBBBBBBBBBBB
BBSBSBSBSBSBSBSBSBSBSBBBB
