BBBBBBBBBBBBBBBBBBBBBBBBB
BFFFFFFFFFFFFFFFFFFFFFFFB
BFFFFFFFFFFFFFFFFFFFFFFFB
BFFFFFFFFFFFFFFFFFFFFFFFB
BFFFFFFFFFFFFFTFFFFFFFFFB
BFFFFFFFFFFFFFFFFFFFFFFFB
BFFPFFFFFFFFFFFFFFFFFFFFB
BFFDDDDDDDDDDDDDDDDDDDFFB
BFFFFFFFFFFFFFFFFFFFFFFFB
BBBBBBBBBBBBBBBBBBBBBBBBB