WWWWWWWWWWWWWWWWWWWWWWWWW
WAAAAAAAAAAAAAAAAAAAAAAAW
WAAAAAAAAAAAAAAAAAAAAAAAW
WAAAAAAAAAAAAAAAAAAAAAAAW
WAAAAAAAAAAPGAAAAAAAAAAAW
WAAAAAAAAAAAAAAAAAAAAAAAW
WAAAAAAAAAAAAAAAAAAAAAAAW
WAAAAAAAAAAAAAAAAAAAAAAAW
WAAAAAAAAAAAAAAAAAAAAAAAW
WWWWWWWWWWWWWWWWWWWWWWWWW
