WWWWWWWWWWWWWWWWWWWWWWWWW
WIIIIIIIIIIIIIIIIIIIIIIIW
WIIIIIIIIIIIIIIIIIIIIIIIW
WIIIIIIIIIIIIIIIIIIIIIIIW
WIIIIIAPGAIIIIIIIIIIIIIIW
WIIIIIIIIIIIIIIIIIIIIIIIW
WIIIIIIIIIIIIIIIIIIIIIIIW
WIIIIIIIIIIIIIIIIIIIIIIIW
WIIIIIIIIIIIIIIIIIIIIIIIW
WWWWWWWWWWWWWWWWWWWWWWWWW
