WWWWWWWWWWWWWWWWWWWWWWWWW
WAWAAWWWWAAAAAAAAAAAWAAAW
WAAAAAAAAWWAAAWWAWWAAAAAW
WWWAAAAAAAAAAAAAAAAAAAAAW
WAAAAAWWWWAWAAAAAAWWWAAAW
WPAAAAAAAAAAAAAAAAAAAAAAW
WAAAAAAAAAAAAAAAAAAAAAAAW
BBBBBBBBBBBBBBBBBBBBBBBBB
BBBBBBBBBBBBBBBBBBBBBBBBB
BBSSSSSSSSSSSSSSSSSSSSSBB
