WWWWWWWWWWWWWWWWWWWWWWWWW
WIIIIIIIIIIIIIIIIIIIIIIIW
WIIIIIIIIIIIIIIIIIIIIIIIW
WIIIIAAAAAIIIAAAAAIIIIIIW
WIIIIAIIIAIIIAIIIAIIIIIIW
WIIIIAIIIAIIIAIIIAIIIIIIW
WIIIIAIIIAIIIAIIIAIIIIIIW
WPAAAAIIIAAAAAIIIAAAAAAGW
IIIIIIIIIIIIIIIIIIIIIIIII
IIIIIIIIIIIIIIIIIIIIIIIII
