WWWWWWWWWWWWWWWWWWWWWWWWW
WIIIIIIIIIIIIIIIIIIIIIIIW
WIIIIIIIIIIIIIIIIIIIIIIIW
WIIIIIIIIIIIIIIIIIIIIIIIW
WIIIIIAAAAAIIIAAGAIIIIIIW
WIIIIIAAAAAAAAAAAAIIIIIIW
WIIIIIAPAAAIIIAAAAIIIIIIW
WIIIIIIIIIIIIIIIIIIIIIIIW
WIIIIIIIIIIIIIIIIIIIIIIIW
WWWWWWWWWWWWWWWWWWWWWWWWW
